0+++++++++++++++++++++0
0+++++++++++++++++++++0
0=====================0
0---------------------0
0---------------------0
0---------------------0
0---------------------0
0---------------------0
00000000000000000000000
00000000000000000000000
00000000000000000000000
